ayyyyyyyyyyyyyyyyyb
xxx-----x-o-------x
xx---o--------xxxxx
x-----------------x
x---xxoxx--------ox
x-----x-----o-----x
x----o------------x
xo---------------ox
xxx-----o------o--x
x-----------------x
cyyyyyyyyyyyyyyyyyd