ayyyyyyyyyyyyb
xyy-----y--o-x
x-o----------x
x---yyy---o--x
x---------y--x
x------------x
x-o-yyyy-----x
x------------x
x-o-----o----x
cyyyyyyyyyyyyd