ayyyyyyyyyyyyyyyyyb
xyy-----y-o-------x
xy---o--------yyyyx
x-----------------x
x---yyoyy--------ox
x-----y-----o-----x
x----o------------x
xo---------------ox
xyy-----o------o--x
x-----------------x
cyyyyyyyyyyyyyyyyyd