ayyyyyyyyyyyyb
xxx--------o-x
x-o----------x
x---------o--x
x------------x
x------------x
x-o-xxxx-----x
x------------x
x-o-----o----x
cyyyyyyyyyyyyd